1111111111111111111111111111111111111111111111111111
10010000000C110010000000C110010000000C110010000000C1
1000011111001100001111100110000111110011000011111001
1P00110000000000011000000000001100000000000110000001
1000C000000011000C000000011000C000000011000C00000001
1111101111111111111011111111111011111111111110111111
1111111111111111111011111111111111111111111110111111
10010000000C110010000000C110010000000C110010000000C1
1000011111001100001111100110000111110011000011111001
1000110000000000011E0000011000110000000000011E000001
1000C000000011000C000000011000C000000011000C00000001
1111111111111111111111111111111111111111111111111111
